1
m.............m
.m...........m.
..m.........m..
...m.......m...
....m.....m....
.....m...m.....
......m.m......
.......p.......
......m.m......
.....m...m.....
....m.....m....
...m.......m...
..m.........m..
.m...........m.
m.............m
